Ne-Yo 	Let Me Love You
The Script 	Hall Of Fame (feat. will.i.am)
P!nk 	Blow Me (One Last Kiss)
Little Mix 	Wings
Sam and The Womp 	Bom Bom
Owl City & Carly Rae Jepsen 	Good Times
Public Enemy 	Harder Than You Think
3 	Taylor Swift 	We Are Never Ever Getting Back Together
Rita Ora 	How We Do (Party)
fun. 	Some Nights
Flo Rida 	I Cry
Florence + the Machine 	Spectrum (Say My Name) (Calvin Harris Mix)
Wiley 	Heatwave (feat. Rymez & Ms D)
Of Monsters and Men 	Little Talks
Cheryl 	Under The Sun
Angel 	Wonderful
Emeli Sand√© 	Read All About It Pt III
Calvin Harris 	We'll Be Coming Back (feat. Example)
Simple Plan 	Summer Paradise (feat. Sean Paul)
Maroon 5 	Payphone (feat. Wiz Khalifa)
Stooshe 	Black Heart
15 	Nicki Minaj 	Pound The Alarm
Rudimental 	Feel The Love (feat. John Newman)
Trey Songz 	Simply Amazing
Alex Clare 	Too Close
Justin Bieber 	As Long As You Love Me (feat. Big Sean)
Plan B 	Deepest Shame
Devlin 	Watchtower (feat. Ed Sheeran)
189 	Elbow 	One Day Like This
Carly Rae Jepsen 	Call Me Maybe
fun. 	We Are Young (feat. Janelle Monae)
Flo Rida 	Whistle
18 	Rita Ora 	R.I.P. (feat. Tinie Tempah)
11 	Chris Brown 	Don't Wake Me Up
Redlight 	Lost In Your Love
2 	Professor Green 	Avalon (feat. Sierra Kusterbeck)
Porter Robinson 	Language
2 	Fazer 	Killer
The Vaccines 	Teenage Icon
will.i.am 	This Is Love (feat. Eva Simons)
